                
NNNNhNNHNHNNNNNN
NNNNhNNHNHNNNNNN
NNNChNNHNHNNNNNN
NNNNhNNNNHNEEEEE
NNNNhNNNNDNEEEEE
pppphppppppEEEEE
SSSShSSSSDSEEEEE
SSSShSSSSHSEEEEE
SSSChSSHSHSSSSSS
SSSShSSHSHSSSSSS
SSSShSSHSHSSSSSS