                
NNNNhNNHNHNNNNNN
NNNNhNNHNHNNNNNN
NNNChNNHNHNNNNNN
NNNNhNNNNHNEEEEE
NNNNhNNNNDHEEEEE
pppphppppppEEEEE
SSSShSSSSDHEEEEE
SSSShSSSSHSEEEEE
SSSChSSHSHSSSSSS
SSSShSSHSHSSSSSS
SSSShSSHSHSSSSSS