      vv        
      vv        
      vv        
NNNNNNvvNNNNTNNN
NNNNNNvvNNNNTEEN
NNNNNDvvNNNNTEEN
NNNNNNvvNNNNTNNN
ppppppvvpppppppp
SSSSSSvvSSSSSSSS
SSSSSDvvSSSCSSSS
SSSSSSvvSSSSSSSS
SSSSSSvvSSSSSSSS